1111111
1C00001
1P00001
1E00001
1000001
1111111